1111111
100N001
1NEESW1
1111111
