NO ./tex.xpm
SO ./tex.xpm
WE ./tex.xpm
EA ./tex.xpm

F 220,100,0
C 225,30,0

11111
10001
10N01
10001
11111
