NO  textures/bluestone.xpm
EA  textures/bluestone.xpm
SO  textures/bluestone.xpm
WE  textures/bluestone.xpm
C   -10,-100,-1
F   83,83,83

  1111111   11111111
  1000001   10001001
  1000001   10001001
  1000001   10000001
  1000001   10000011
  1111111   1000001
            10000011
1111111111111000001
10000000000000000001
100000000000000000011
100001111000111000001111111
100001  1001100000000000001111111111111111111111111111111111111
100001  10000000000000000000000000000001             1000000001
100001  1000000000000000001111111111111111           1111111111
100001  10000000000000000011                                      
111111  1111111111110000001                                       
                   10010001                                       
                   10010001                                       
                   10010001                                       
1111111111111111111100000011111111111111111111111111111111111111111
1000000000000000000000000000000000000000000000000000000000000000001
1000011110000000000000000000000000000000000000000000000000000000001
1000000000001111111100011110000001111000000111100000011110000000001
1000011111111110000000000000000000000000000000000000000000000000001
1000000000000000001100000110000000011000000001100000000110000000001
1000000000000000000000000000000000000000000000000000000000000000001
1000000000000000000000000000000000000000000000000000000000000000001
1001110000011100111111111001110000001110000000000011111100000011101
1001110000011100111111111001110000001110000000000111001110000011101
1001110000011100111000000001110000001110000000001110000111000011101
10011100000111001110000000011100000S1110000000011100000011100011101
1001110000011100111000000001110000001110000000111000000001110011101
1001110000011100111000000001110000001110000001110000000000111011101
1001111111111100111111111001110000001110000001110000000000111011101
1001111111111100111111111001110000001110000001110000000000111011101
1001111111111100111111111001110000001110000001110000000000111011101
1001110000011100111000000001110000001110000001110000000000111011101
1001110000011100111000000001110000001110000001110000000000111011101
1001110000011100111000000001110000001110000001110000000000111011101
1001110000011100111000000001110000001110000000111000000001110011101
1001110000011100111000000001110000001110000000011100000011100000001
1001110000011100111111111001111111101111111100001110000111000111001
1001110000011100111111111001111111101111111100000111001110000111001
1001110000011100111111111001111111101111111100000011111100000111001
1000000000000000000000000000000000000000000000000000000000000000001
1111111111111111111111111111111111111111111111111111111111111111111
