11111
10001
10001
10P01
11111
